1001	1	30	0	40	35	40	45	30	30	2	4	10	1	849	417
Black Panther
1002	1	50	0	45	45	30	30	30	30	3	5	30	1	546	885
Dwarf Bandit
1003	1	50	0	45	45	25	25	30	30	4	6	50	2	627	576
Heavyarmoured Dwarf Bandit
1004	2	75	0	50	50	30	30	30	30	7	10	50	3	756	483
Dwarf Bandit's Commander
1005	3	100	0	55	55	35	35	30	40	10	15	75	5	699	408
Dwarf Bandit's Leader